"a" = (/turf/template_noop,/area/space)
"b" = (/turf/closed/mineral/random,/area/ruin/space/has_grav)
"c" = (/turf/closed/wall/mineral/sandstone,/area/ruin/space/has_grav)
"d" = (/turf/open/floor/plating/asteroid,/area/ruin/space/has_grav)
"e" = (/mob/living/simple_animal/hostile/asteroid/goliath,/turf/open/floor/plating/asteroid,/area/ruin/space/has_grav)
"f" = (/obj/item/book/granter/spell/smoke/lesser,/turf/open/floor/plating/asteroid,/area/ruin/space/has_grav)
"g" = (/obj/item/book/granter/spell/summonitem,/turf/closed/mineral/random,/area/ruin/space/has_grav)
"h" = (/turf/closed/wall/rust,/area/ruin/space/has_grav)
"i" = (/mob/living/simple_animal/hostile/asteroid/hivelord,/turf/open/floor/plating/asteroid,/area/ruin/space/has_grav)
"j" = (/obj/item/mining_scanner,/turf/open/floor/plating/asteroid,/area/ruin/space/has_grav)
"k" = (/obj/item/pickaxe/drill,/turf/open/floor/plating/asteroid,/area/ruin/space/has_grav)
"l" = (/obj/item/stack/ore/iron{amount = 15; pixel_x = 15; pixel_y = 5},/obj/item/stack/ore/titanium{amount = 10; pixel_x = 5; pixel_y = -2},/turf/open/floor/plating/asteroid,/area/ruin/space/has_grav)
"m" = (/obj/item/stack/ore/plasma{amount = 5; pixel_x = -15; pixel_y = -10},/obj/item/stack/ore/uranium{pixel_x = -10},/obj/item/stack/ore/copper{amount = 5; pixel_x = 6; pixel_y = 5},/turf/open/floor/plating/asteroid,/area/ruin/space/has_grav)
"n" = (/obj/item/stack/ore/plasma{amount = 10; pixel_x = -10; pixel_y = -10},/turf/open/floor/plating/asteroid,/area/ruin/space/has_grav)
"o" = (/obj/item/stack/ore/titanium,/turf/open/floor/plating/asteroid,/area/ruin/space/has_grav)
"p" = (/obj/item/stack/ore/iron{amount = 20; pixel_x = -15; pixel_y = 10},/obj/item/stack/ore/silver{amount = 5; pixel_x = 7; pixel_y = -3},/obj/item/stack/ore/diamond{pixel_x = 5; pixel_y = 10},/obj/item/stack/ore/copper{amount = 10; pixel_x = 5; pixel_y = -10},/turf/open/floor/plating/asteroid,/area/ruin/space/has_grav)
"q" = (/obj/item/stack/ore/iron{amount = 15; pixel_x = -10; pixel_y = -4},/obj/item/stack/ore/silver{amount = 2; pixel_x = -16; pixel_y = -4},/obj/item/stack/ore/copper{amount = 5; pixel_x = -9; pixel_y = 5},/turf/open/floor/plating/asteroid,/area/ruin/space/has_grav)
"r" = (/obj/item/stack/ore/gold{amount = 2; pixel_x = 13; pixel_y = 10},/turf/open/floor/plating/asteroid,/area/ruin/space/has_grav)
"s" = (/obj/item/stack/ore/gold{amount = 2; pixel_x = 13},/mob/living/simple_animal/hostile/asteroid/basilisk,/turf/open/floor/plating/asteroid,/area/ruin/space/has_grav)
"t" = (/obj/item/stack/ore/iron{amount = 5; pixel_x = -10; pixel_y = 3},/obj/item/stack/ore/bluespace_crystal{pixel_x = -5; pixel_y = 10},/turf/open/floor/plating/asteroid,/area/ruin/space/has_grav)
"u" = (/turf/closed/wall/rust,/area/ruin/space/has_grav/powered)
"v" = (/turf/open/floor/plating,/area/ruin/space/has_grav/powered)
"w" = (/turf/open/floor/plating,/area/ruin/space/has_grav)
"x" = (/obj/machinery/power/port_gen/pacman,/turf/open/floor/plating,/area/ruin/space/has_grav)
"y" = (/obj/structure/ore_box,/turf/open/floor/plating,/area/ruin/space/has_grav)
"z" = (/obj/machinery/conveyor{icon_state = "conveyor_map"; dir = 4},/turf/open/floor/plating,/area/ruin/space/has_grav)
"A" = (/obj/machinery/conveyor{icon_state = "conveyor_map"; dir = 4},/obj/machinery/door/poddoor,/turf/open/floor/plating,/area/ruin/space/has_grav)
"B" = (/obj/machinery/conveyor{icon_state = "conveyor_map"; dir = 4},/obj/structure/plasticflaps,/turf/open/floor/plating,/area/ruin/space/has_grav)
"C" = (/obj/item/stack/medical/bruise_pack,/turf/open/floor/plating/asteroid,/area/ruin/space/has_grav)
"D" = (/obj/item/stack/sheet/glass/fifty,/turf/open/floor/plating,/area/ruin/space/has_grav/powered)
"E" = (/mob/living/simple_animal/hostile/asteroid/hivelord,/turf/open/floor/plating,/area/ruin/space/has_grav)
"F" = (/obj/item/stack/medical/ointment,/turf/open/floor/plating/asteroid,/area/ruin/space/has_grav)
"G" = (/obj/machinery/door/airlock/hatch,/turf/open/floor/plating,/area/ruin/space/has_grav/powered)
"H" = (/obj/machinery/door/airlock/hatch,/turf/open/floor/plating,/area/ruin/space/has_grav)
"I" = (/obj/item/stack/spacecash/c500,/turf/open/floor/plating/asteroid,/area/ruin/space/has_grav)
"J" = (/obj/machinery/portable_atmospherics/canister/air,/turf/open/floor/plating,/area/ruin/space/has_grav/powered)
"K" = (/obj/machinery/portable_atmospherics/scrubber,/turf/open/floor/plating,/area/ruin/space/has_grav/powered)
"L" = (/obj/item/radio/off,/turf/open/floor/plating,/area/ruin/space/has_grav/powered)
"M" = (/obj/machinery/portable_atmospherics/pump,/turf/open/floor/plating,/area/ruin/space/has_grav/powered)
"N" = (/obj/item/tank/internals/oxygen,/obj/item/tank/internals/oxygen,/obj/item/tank/jetpack/improvised,/turf/open/floor/plating,/area/ruin/space/has_grav)
"O" = (/obj/machinery/portable_atmospherics/canister/oxygen,/turf/open/floor/plating,/area/ruin/space/has_grav)
"P" = (/turf/open/floor/plasteel,/area/ruin/space/has_grav)
"Q" = (/obj/machinery/door/airlock/hatch,/turf/open/floor/plasteel,/area/ruin/space/has_grav)
"R" = (/obj/structure/chair,/turf/open/floor/plasteel,/area/ruin/space/has_grav)
"S" = (/mob/living/simple_animal/hostile/asteroid/hivelord,/turf/open/floor/plasteel,/area/ruin/space/has_grav)
"T" = (/obj/structure/bed,/turf/open/floor/plasteel,/area/ruin/space/has_grav)
"U" = (/obj/structure/table,/turf/open/floor/plasteel,/area/ruin/space/has_grav)
"V" = (/obj/machinery/vending/coffee,/turf/open/floor/plasteel,/area/ruin/space/has_grav)

(1,1,1) = {"
aaaaaaaaaaaaaaaaaaaaaaaaaaaaaaaaaaaaaaaa
aaaaaaaaaaaaaaaaaaaaaaaaaaaaaaaaaaaaaaaa
aaaaaaaaaaaaaaaaaaaaaaaaaaaaaaaaaaaaaaaa
aaaaaaaaaaaaaaaaaaaaaaaaaaaaaaaaaaaaaaaa
aaaaaaaabbaaaaaaaaaaaabbaaaaaaaaaaaaaaaa
aaaaaabbbbabbbbbbbabbbbbbaaaaaaaaaaaaaaa
aaaaaabbbbbbbbbbbbabbbbbbbbbaaaaaaaaaaaa
aaaaabbbbbbbbbbbbbbbbbbbbbbbbbbaaaaaaaaa
aaaabbbbbbbbbbbbbbbbbbbbbbbbbbbaaaaaaaaa
aaabbbbbbbbbbbbbbbbbbbbbbbbbbbbbaaaaaaaa
aaabbbbbbbbbbbcccccccbbbbbbbbbbbbaaaaaaa
aaabbbbbbbbbbbcdedddcbbbbbbbbbbbbbaaaaaa
aaabbbbbbbbbbbcdddfdcbbbbbbbbbbbbbbaaaaa
aaabbbbbbbbbddddddddcbbbbbbbbbbbbbbbaaaa
aabbbbbbbbbbdbcccccccbbbbbbbbbbbbbbbaaaa
aabbbbbbbbbbdbbbbggbbbbbbbbbbbbbbbbbbbaa
aabbbbbbbbbddbbbbggbbbbbbbbbbbhhhhhhhhaa
abbbbbbbbbbidbbbbggbbbbbbbbbbbhaaaaaaaaa
abbbbbbbbbbjkbbbbbbbbbbbbbbbbbhaaaaaaaaa
abbbbbbbbbbddlmnbbbbbbbbbbbbbbhaaaaaaaaa
abbbbbbbbbbbdopqbbbbbbbbbbbbbbhaaaaaaaaa
aabbbbbbbbbbdrstuuuuhhhhhhhhhhhaaaaaaaaa
aabbbbbbbbbbdddduvvvwxhywwzzABAaaaaaaaaa
aabbbbbbbbbddCdduDvvEwhwwwwwhhhaaaaaaaaa
aabbbbbbbbddCFddGvvvwwHwwwwwHwHaaaaaaaaa
aabbbbbbbbddddIduJKLwwhwywywhhhaaaaaaaaa
aabbbbbbbbbddjdbuJMvNOhwwwwEhbhaaaaaaaaa
aabbbbbbbbbbdkdduuuuhhhHhhhhhbhaaaaaaaaa
aabbbbbbbbbbddidbbbbbbhPPQPRhbhaaaaaaaaa
aabbbbbbbbbbbbbbbbbbbbhSPhTUhbhhhhhhhhha
aabbbbbbbbbbbbbbbbbbbbhPPhhhhbbbbbbbbbba
aaabbbbbbbbbbbbbbbbbbbhVPQPRhbbbbbbbbbaa
aaabbbbbbbbbbbbbbbbbbbhhhhTUhbbbbbbbbaaa
aaaabbbbbbbbbbbbbbbbbbbbbhhhhbbbbbbbaaaa
aaaaabbbbbbbbbbbbbbbbbbbbbbbbbbbaaaaaaaa
aaaaabbbbbbbbbbbbbbbbbbbbbbbaaaaaaaaaaaa
aaaaaaabbabbbbbbbbbbbbbbbbbbaaaaaaaaaaaa
aaaaaaaaaabbbbbbbbbbbbbbbbaaaaaaaaaaaaaa
aaaaaaaaaaabbbbbbbabbaaaaaaaaaaaaaaaaaaa
aaaaaaaaaaaaaaaaaaaaaaaaaaaaaaaaaaaaaaaa
"}
